{
  "data": [
    "┌──────────────────────────────────────────────────────────────────────────────────────────────────┐",
    "│                                             vvvv    map2                                         │",
    "│                                                                                                  │",
    "│                                                                                                  │",
    "│                                                                                                  │",
    "│                                                                                                  │",
    "│                                                                                                  │",
    "│                                                                                                  │",
    "│                                                                                                  │",
    "│                                                                                                  │",
    "│                                                                                                  │",
    "│                                                                                                  │",
    "│                                                                                                  │",
    "│                                                                                                  │",
    "│                                                                                                  │",
    "│>                                                                                                <│",
    "│>                                                                                                <│",
    "│>                                                                                                <│",
    "│>                                                                                                <│",
    "│                                                                                                  │",
    "│                                                                                                  │",
    "│                                                                                                  │",
    "│                                                                                                  │",
    "│                                                                                                  │",
    "│                                                                                                  │",
    "│                                                                                                  │",
    "│                                                                                                  │",
    "│                                                                                                  │",
    "│                                                                                                  │",
    "│                                                                                                  │",
    "│                                                                                                  │",
    "│                                                                                                  │",
    "│                                                                                                  │",
    "│                                             ^^^^                                                 │",
    "└──────────────────────────────────────────────────────────────────────────────────────────────────┘"
  ],
  "adjacent_maps": {
    "north": null,
    "south": "map1",
    "east": null,
    "west": null
  },
  "common_NPCs": [
    { "name": "wolf", "race": "Wolf", "id": "Wolf3", "relationship": "Enemy", "spawn_location": [10, 10], "location": [10, 10], "health": 100, "level": 1},
    { "name": "wolf", "race": "Wolf", "id": "wolf4", "relationship": "Enemy", "spawn_location": [3, 20], "location": [3, 20], "health": 100, "level": 1}
  ],
  "unique_NPCs": [
    "Harold"
  ]
}