{
  "data": [
    "┌──────────────────────────────────────────────────────────────────────────────────────────────────┐",
    "│                                             vvvv    map3                                         │",
    "│                                                                                                  │",
    "│                                                                                                  │",
    "│                                                                                                  │",
    "│                                                                                                  │",
    "│                                                                                                  │",
    "│                                                                                                  │",
    "│                                                                                                  │",
    "│                                                                                                  │",
    "│                                                                                                  │",
    "│                                                                                                  │",
    "│                                                                                                  │",
    "│                                                                                                  │",
    "│                                                                                                  │",
    "│>                                                                                                <│",
    "│>                                                                                                <│",
    "│>                                                                                                <│",
    "│>                                                                                                <│",
    "│                                                                                                  │",
    "│                                                                                                  │",
    "│                                                                                                  │",
    "│                                                                                                  │",
    "│                                                                                                  │",
    "│                                                                                                  │",
    "│                                                                                                  │",
    "│                                                                                                  │",
    "│                                                                                                  │",
    "│                                                                                                  │",
    "│                                                                                                  │",
    "│                                                                                                  │",
    "│                                                                                                  │",
    "│                                                                                                  │",
    "│                                             ^^^^                                                 │",
    "└──────────────────────────────────────────────────────────────────────────────────────────────────┘"
  ],
  "adjacent_maps": {
    "north": "map1",
    "south": null,
    "east": null,
    "west": null
  },
  "common_NPCs": [
    { "race": "Wolf", "id": "Wolf5", "spawn_location": [10, 10], "location": [10, 10], "health": 100, "level": 1},
    { "race": "Wolf", "id": "wolf6", "spawn_location": [3, 20], "location": [3, 20], "health": 100, "level": 1}
  ],
  "unique_NPCs": []
}